7,20
10111111111111
10200010000001
10100110000000
10000010020000
10000000000011
10000010000111
11111111111111